175 186 186 186 186 186 186 186 186 186 186 186 186 186 186 186 186 186 186 186 186 186 186 186 186 186 186 186 186 186 186 186 186 186 186 186 186 186 186 186 186 186 186 186 186 186 186 186 186 197 
208 38 38 38 38 38 38 127 132 38 38 38 38 38 38 38 38 38 38 38 233 38 38 38 38 38 38 159 38 38 38 38 38 233 38 38 38 38 38 38 38 38 38 38 159 38 38 126 130 208 
208 38 165 38 199 38 38 128 133 38 38 233 293 298 302 306 38 113 117 122 38 38 38 38 212 213 38 160 38 38 38 135 139 38 167 169 38 38 38 38 113 117 122 178 157 38 199 127 132 208 
208 57 38 38 151 38 38 129 134 57 38 38 294 299 303 308 38 114 118 123 38 126 130 193 194 38 240 242 243 244 38 136 140 38 168 170 126 130 58 38 114 118 123 38 145 146 38 128 133 208 
208 38 135 139 240 242 243 244 152 38 38 38 295 304 304 309 38 115 119 124 38 127 132 195 196 38 245 246 247 248 38 137 141 38 38 38 127 132 38 38 115 119 124 154 147 148 38 149 134 208 
208 38 136 140 245 246 247 248 38 167 169 60 297 301 305 310 38 116 121 125 176 127 133 38 38 233 249 250 251 253 152 138 143 207 38 38 128 133 38 38 116 121 125 38 149 150 206 38 38 208 
208 38 137 141 249 250 251 253 38 168 170 38 24 25 26 38 38 206 38 158 154 129 134 38 233 177 254 255 256 257 38 38 38 38 61 38 129 134 209 38 38 38 152 240 242 243 244 38 38 208 
208 204 138 143 254 255 256 257 62 38 176 38 30 31 33 57 38 38 38 38 38 62 145 146 38 24 25 26 212 213 173 38 38 163 38 38 38 145 146 38 38 38 38 245 246 247 248 38 177 208 
208 38 60 38 24 25 26 178 38 38 38 57 38 145 146 233 240 242 243 244 104 38 147 148 38 27 28 90 35 104 165 38 293 298 302 306 38 147 148 38 193 194 38 249 250 251 253 233 38 208 
208 145 146 233 27 28 71 26 38 293 298 302 306 147 148 38 245 246 247 248 233 151 149 150 38 27 71 94 35 104 38 38 294 299 303 308 59 149 150 38 195 196 38 254 255 256 257 206 38 208 
208 147 148 155 30 73 28 29 233 294 299 303 308 149 150 38 249 250 251 253 159 38 158 38 38 27 28 28 35 38 38 233 295 300 304 309 38 38 24 25 25 26 24 25 26 212 213 38 38 208 
208 149 150 38 46 27 28 36 25 295 300 304 309 180 181 38 254 255 256 257 157 38 38 38 38 30 70 28 35 229 38 233 297 301 305 310 24 25 71 28 28 28 94 28 29 113 117 122 221 208 
208 38 126 130 38 165 27 71 33 297 301 305 310 38 24 25 25 25 25 25 25 25 25 25 25 25 91 28 35 38 38 38 24 26 233 38 30 28 69 31 31 31 31 31 33 114 118 123 38 208 
208 38 127 132 38 38 233 27 25 25 25 25 25 25 42 28 70 31 31 31 31 31 31 31 31 31 47 28 29 39 39 39 69 94 36 39 39 28 33 38 82 38 126 130 38 115 119 124 38 208 
208 38 128 133 113 117 122 30 31 31 31 31 31 31 31 31 33 56 38 180 181 167 169 126 130 59 27 28 28 28 95 28 28 28 69 28 29 233 38 38 82 82 127 132 159 116 121 125 207 208 
208 38 129 134 114 118 123 145 146 38 152 38 38 38 126 130 212 213 38 38 38 168 170 127 132 58 27 28 71 34 37 37 37 37 31 31 33 113 117 122 145 146 128 133 160 152 38 158 38 208 
208 61 156 38 115 119 124 147 148 167 169 113 117 122 127 132 145 146 113 117 122 38 38 128 133 38 27 28 28 36 177 38 229 126 130 145 146 114 118 123 147 148 129 134 113 117 122 172 38 208 
208 38 157 172 116 121 125 149 150 168 170 114 118 123 128 133 147 148 114 118 123 212 213 129 134 38 27 28 28 29 167 169 38 127 132 147 148 115 119 124 149 150 176 38 114 117 123 38 38 208 
208 154 145 146 126 130 113 117 122 145 146 115 119 124 129 134 149 150 115 119 124 38 135 139 145 146 27 72 28 29 168 170 38 128 133 149 150 116 121 125 155 145 146 38 115 119 124 223 38 208 
208 38 147 148 127 132 114 118 123 147 148 116 121 125 167 169 199 38 116 121 125 38 136 140 147 148 27 28 28 29 113 117 122 129 134 38 165 38 199 38 38 147 148 38 116 121 125 38 162 208 
208 199 149 150 127 133 115 119 124 149 150 38 38 38 168 170 38 177 165 38 152 38 137 141 149 150 27 28 28 29 114 118 123 38 126 130 38 145 146 233 233 149 150 38 38 38 178 126 130 208 
208 113 117 122 129 134 116 121 125 38 178 38 61 38 163 126 130 38 173 38 38 38 138 143 38 199 27 94 28 29 115 119 124 38 127 132 38 147 148 38 135 139 206 38 145 146 38 127 132 208 
208 114 118 123 156 38 151 38 209 126 130 38 24 25 26 127 132 154 38 162 38 58 113 117 122 38 27 28 28 29 116 121 125 58 128 133 38 149 150 38 136 140 38 155 147 148 38 128 133 208 
208 115 119 124 157 145 146 223 38 127 132 61 27 91 29 128 133 155 38 135 139 38 114 118 123 38 27 28 72 29 193 194 209 58 129 134 38 154 38 171 137 141 163 38 149 150 38 129 134 208 
208 116 121 125 38 147 148 38 38 128 133 58 27 89 29 129 134 38 38 136 140 38 115 119 124 38 27 28 28 29 195 196 145 146 38 113 117 122 58 38 138 143 38 38 58 38 38 38 38 208 
208 38 126 130 233 149 150 38 38 129 134 24 28 90 29 38 38 145 146 137 141 209 116 121 125 154 27 28 28 29 135 139 147 148 38 114 117 123 58 38 38 163 126 130 58 113 117 122 38 208 
208 154 127 132 38 223 38 38 38 159 38 30 31 31 33 180 181 147 148 138 143 38 145 146 126 130 27 28 28 29 136 140 149 150 38 115 119 124 38 167 169 38 127 132 38 114 118 123 38 208 
208 38 128 133 113 117 122 38 38 160 173 155 38 178 38 152 38 149 150 135 139 61 147 148 127 132 27 90 28 29 137 141 38 38 58 116 121 125 38 168 170 38 128 133 38 115 119 124 38 208 
208 165 129 134 114 118 123 38 152 126 130 38 38 38 38 167 169 38 38 136 140 154 149 150 128 133 27 28 28 29 138 143 159 38 58 38 38 206 38 145 146 38 129 134 38 116 121 125 38 208 
208 38 38 38 115 119 124 38 38 127 132 38 113 117 122 168 170 38 38 137 141 38 38 38 129 134 27 28 28 29 38 38 160 126 130 38 199 38 38 147 148 38 38 135 139 38 38 38 38 208 
208 38 38 38 116 121 125 38 38 128 133 38 114 118 123 38 38 145 146 138 143 113 117 122 38 38 27 28 28 29 113 117 122 127 132 38 38 38 38 149 150 38 38 136 140 38 38 38 38 208 
208 38 38 38 38 38 145 146 38 129 134 38 115 119 124 38 104 147 148 38 38 114 118 123 167 169 27 28 94 29 114 118 123 128 133 38 38 38 38 38 38 38 38 137 141 38 38 38 38 208 
208 38 165 38 38 104 147 148 38 113 117 122 116 121 125 104 104 149 150 38 38 115 119 124 168 170 27 28 28 29 115 119 124 129 134 38 38 38 38 56 38 38 38 138 143 38 38 56 38 208 
208 38 38 38 135 139 149 150 38 114 118 123 38 38 38 126 130 104 38 38 38 116 121 125 38 38 27 28 28 29 116 121 125 154 38 38 38 38 38 38 38 38 38 224 38 182 184 187 38 208 
208 38 38 38 136 140 38 38 38 115 119 124 38 178 38 127 132 38 38 38 260 261 262 24 25 25 68 28 28 66 25 25 26 282 283 284 233 38 38 235 38 38 103 38 163 183 185 188 38 208 
208 38 38 38 137 141 154 38 38 116 121 125 38 38 38 128 133 38 233 38 264 265 38 27 28 73 28 28 28 72 28 28 29 286 287 288 222 275 38 236 38 224 38 38 233 163 38 38 38 208 
208 38 38 38 138 143 38 38 165 38 135 139 38 38 38 129 134 38 218 38 267 268 269 27 92 28 28 93 28 28 28 95 29 289 290 291 38 275 38 237 38 38 38 38 38 56 38 38 38 208 
208 104 145 146 38 38 126 130 38 38 136 140 38 38 38 235 38 38 38 38 85 86 88 61 40 28 28 28 93 28 73 34 58 85 86 88 275 275 38 38 38 38 38 38 38 38 38 63 38 208 
208 38 147 148 38 38 127 132 38 38 137 141 38 38 38 236 113 117 122 38 38 38 38 38 41 90 28 28 93 28 90 35 38 38 38 275 275 63 113 117 122 38 177 38 38 38 38 38 38 208 
208 38 149 150 38 59 128 133 38 38 138 143 38 56 38 236 114 118 123 38 38 233 38 38 38 30 31 31 31 31 93 38 38 38 145 146 38 38 114 118 123 38 38 38 167 169 38 38 177 208 
208 38 38 38 38 38 129 134 38 38 38 38 38 218 38 237 115 119 124 38 38 38 38 63 38 63 275 271 272 273 38 222 38 38 147 148 38 38 115 119 124 38 38 38 168 170 38 38 38 208 
208 38 59 38 38 38 154 38 38 218 38 218 38 38 38 38 116 121 125 38 126 130 38 38 38 275 275 275 276 277 38 38 104 154 149 150 38 38 116 121 125 38 38 38 38 38 38 232 38 208 
208 38 38 165 38 38 38 38 38 167 169 38 38 38 38 159 38 206 38 38 127 132 38 56 38 38 233 278 279 280 57 38 38 104 104 38 38 38 38 38 38 38 199 56 38 38 38 38 38 208 
208 38 38 182 184 187 38 218 38 168 170 126 130 38 38 160 38 38 38 38 128 133 38 38 38 38 275 85 86 88 224 233 38 38 182 184 187 38 38 38 126 130 38 199 38 145 146 38 38 208 
208 38 38 183 185 188 38 38 38 38 38 127 132 38 38 38 38 38 38 38 129 134 38 38 38 38 62 38 38 275 275 38 38 38 183 185 188 165 38 38 127 132 38 38 38 147 148 38 38 208 
208 38 152 189 190 38 199 38 38 163 38 128 133 38 38 38 167 169 38 38 38 38 38 38 38 38 38 38 233 38 275 38 38 38 38 38 38 38 56 38 128 133 38 38 104 149 150 38 38 208 
208 59 38 191 192 38 38 38 59 38 38 129 134 38 38 38 168 170 38 212 213 167 169 38 38 38 38 38 38 38 275 212 213 38 56 38 232 38 38 38 129 134 38 38 38 38 38 63 38 208 
208 38 38 165 38 217 38 38 38 38 165 38 38 38 38 56 38 38 38 38 38 168 170 38 232 38 38 38 38 38 275 275 38 38 38 38 38 38 38 38 38 38 38 63 38 38 38 38 38 208 
208 266 38 38 38 38 38 38 38 38 38 38 38 38 38 38 38 38 38 38 38 38 38 38 38 38 38 38 38 56 38 38 38 38 38 38 38 38 38 38 38 38 38 38 38 56 38 38 38 208 
230 241 241 241 241 241 241 241 241 241 241 241 241 241 241 241 241 241 241 241 241 241 241 241 241 241 241 241 241 241 241 241 241 241 241 241 241 241 241 241 241 241 241 241 241 241 241 241 241 19 
